#############################
#.........c.................#
#.......xx.....c..c.........#
#....c.x..x............p....#
#..####...c...###...........#
#.......c.........c.........#
#....x..c...x...............#
#...............c....##.....#
#..c..c.........#...........#
#...........................#
#############################
