#####################
#.........c.........#
#.......xx.....c..c.#
#....c.x..x.........#
#..####...c...###...#
#.......c.........c.#
#....x..c...x.......#
#...............c...#
#..c..c.........#...#
#...................#
#.....c....xx.......#
#....###....c....c..#
#....ccc............#
#......x...c........#
#.......c...........#
#####################
